10 12
.........T..
XX...XX...X.
X..G......X.
XXXXXXX...XG
..........X.
....XGX...X.
....XXX...XK
.....XX.K.X.
............
XS...XX.....
